A	AH
A(2)	EY
AME	EY M
ASKETBALL	AE S EH T B AH L
ASSHEHALL	AE S AH HH AH L
BASKETBALL	B AE S K AH T B AO L
DARE	D EH R
FUN	F AH N
GAME	G EY M
HEIR	EH R
I	AY
IS	IH Z
LAY	L EY
LEHS	L EH Z
LENS	L EH N Z
LETS	L EH T S
OU	UW
PLAY	P L EY
UN	AH N
UN(2)	Y UW EH N
YOU	Y UW
